map
111111111111111111111111111111111111111111111111111111111111
100000000000000000000000000000000000000000000000000000000001
100000000000000000000000000000000000000000000000000000000001
1p000000000u0000000000000000u0000000000000000u000000000p0001
111111111111111111111111111111111111111111111111111111110001
100000000000000000000000000000000000000000000000000000010001
100000000000000000000000000000000000000000000000000000010001
1000u0000000000000000000000000000000000000000000000u00010001
100011111111111111111111111111111111111111111111111100010001
100010000000000000000000000000000000000000000000000100010001
100010000000000000000000000000000000000000000000000100010001
10001000u00000000000000000000000000000000000000u000100010001
100010001111111111111111111111111111111111111111000100010001
100010001000000000000000000000000000000000000001000100010001
100010001000000000000000000000000000000000000001000100010001
100010001000000000000000000000000000000000000001000100010001
100010001000100000000000000000000000000000000001000100010001
1000100010001u00000000000000000000000000000000u1000100010001
100010001000111111111111111111111111111111111111000100010001
100010001000000000000000000000000000000000000000000100010001
100010001000000000000000000000000000000000000000000100010001
100010001u0000000000000000000000000000000000000000u100010001
100010001111111111111111111111111111111111111111111100010001
100010000000000000000000000000000000000000000000000000010001
100010000000000000000000000000000000000000000000000000010001
10001u000000000000000000000000000000000000000000000000u10001
100011111111111111111111111111111111111111111111111111110001
100000000000000000000000000000000000000000000000000000000001
100000000000000000000000000000000000000000000000000000000001
1p000000000u0000000000000000u0000000000000000u000000000p0001
111111111111111111111111111111111111111111111111111111111111