map
00000000000000000000000000000000000000000000000000000000000000000
00000000000000000000000000000000000000000000000000000000000000000
00000000000000000000000000000000000000000000000000000000000000000
00000000000000000000000000000000000000000000000000000000000000000
00000000000000000000000000000000100000000000000000000000000000000
00000000000000000010000000000000100000000000000100000000000000000
0000000000000000001000000p0000001000000p0000000100000000000000000
00000000000000000010000111110000100001111100000100000000000000000
00000000000000000010000000000000100000000000000100000000000000000
0000000000p00000001000000000000000000000000000010000000p000000000
00000000011111000000000000000000000000000000000000001111100000000
00000000000000000000000000000000000000000000000000000000000000000
00000000000000000000000000000000000000000000000000000000000000000
00000000000000000000000000000000000000000000000000000000000000000
00000000000000000000000000000000000000000000000000000000000000000
00000000000000000000000000000000000000000000000000000000000000000
00000000000000000000000000000000000000000000000000000000000000000
00000000000000000001111111111000000011111111111000000000000000000
00000000000000000000000000000000000000000000000000000000000000000
00000000000000000000000000000000000000000000000000000000000000000
00000001111111100000000000000000000000000000000000111111110000000
00000000000100000000000000000000000000000000000000000100000000000
0000000000u1000000000000000000000000000000000000000001u0000000000
00000000111100000000011111111110001111111111000000000111100000000
00000000000000000000000000000000000000000000000000000000000000000
00000000000000000000000000000000000000000000000000000000000000000
00000000000000000000000000000000000000000000000000000000000000000
00000000000000000000000000000000u00000000000000000000000000000000
00000000000000000000000000000111111100000000000000000000000000000
00000000000000000000000000000000000000000000000000000000000000000
00000000000000000000000000000000000000000000000000000000000000000
00000000000000000000000000000000000000000000000000000000000000000
000000000000u000000001111111111111111111111100000000u000000000000
00000111111111111111111111111111111111111111111111111111111100000
00000000000000000000000000000000000000000000000000000000000000000
00000000000000000000000000000000000000000000000000000000000000000
0000000000000000000000000000u000u000u0000000000000000000000000000
00000000000000000000000000011111111111000000000000000000000000000
00000000000000000000000000000000000000000000000000000000000000000