map
10000001111111111111111111111111111111111111111111111111110000001
10000000000011000000000000000000000000000000000000011000000000001
1000000000001100000000000u0000000000000u0000000000011000000000001
1000000u0u0u11000000000111111000000011111100000000011u0u0u0000001
10000001111111000000000000000000000000000000000000011111110000001
10000001111111000000000000000100000100000000000000011111110000001
1000000110000000000000000000u1000001u0000000000000000000110000001
100000011p000000000000000001110000011100000000000000000p110000001
10000001111111000000000000000000000000000000000000011111110000001
10000001000000000000000000000000000000000000000000000000010000001
10000001000u0000000000000000000000000000000000000000u000010000001
10000001001111111100000000000000000000000000000111111110010000001
10000001000000000000000000000000000000000000000000000000010000001
10000001000000000000000000000000000000000000000000000000010000001
10000001000000000000000000000110001100000000000000000000010000001
10000001000000000000000000000100000100000000000000000000010000001
10000001000000000000000000000100000100000000000000000000010000001
1000000100000000000000000000010u0u0100000000000000000000010000001
10000001000000000000000000000111111100000000000000000000010000001
10000001000000000000000000000000000000000000000000000000010000001
10000001000000000u00000000000000000000000000000u00000000010000001
10000001000000001111111111111000000011111111111110000000010000001
10000001000000000000000000000000000000000000000000000000010000001
10000001000000000000000000000000000000000000000000000000010000001
10000001000000000000000000000000000000000000000000000000010000001
10000001111100000000000000000000000000000000000000000111110000001
10000001000000000000000000001000000010000000000000000000010000001
10000001p00000000000000000001000000010000000000000000000p10000001
10000001111100000000000000001000000010000000000000000111110000001
10000001000000000000000000001000000010000000000000000000010000001
10000001000000000000000000001000000010000000000000000000010000001
10000001u000000000000000000u100000001u000000000000000000u10000001
10000001111111111111111111111000p00011111111111111111111110000001
10000000000000000000000000000000100000000000000000000000000000001
10000000000000000000000000000000100000000000000000000000000000001
100000000000000000000000000000u010u000000000000000000000000000001
11111111111111111111111111111111111111111111111111111111111111111