map
1111111111111111111111111111111111111111111111
1000000100000000000000110000000000000010000001
1p0u0001000000u00000000000000000u000001000u0p1
1111100100000111000000110000000111000010011111
1000000100000000000000110000000000000010000001
1000000100000000000000110000000000000010000001
1000000000000000000000000000000000000000000001
1000000000001000000011111100000001000000000001
1u000000000000000000001100000000000000000000u1
1111100000000000000u000000u0000000000000011111
1000000000001000001111111111000001000000000001
1p000000000010000000001100000000010000000000p1
1111100000000000000000110000000000000000011111
1000000000001000000000000000000001000000000001
1000000000001000000000000000000001000000000001
1000000000000000000000110000000000000000000001
10000000000000000u0000110000u00000000000000001
1000000000111111111111111111111111110000000001
1000000000000000000000110000000000000000000001
1000000000000000000000110000000000000000000001
1000000000000000000001111000000000000000000001
1000000000000000111111111111110000000000000001
1000000100000000111111001111110000000010000001
1111100100000000110000000000110000000010011111
1000000100000000110000000000110000000010000001
1p0u00010000000000000u00u00000000000001000u0p1
1111111111111111111111111111111111111111111111