map
111111111111111111111111111111111111111
100001000000000000000000000000001000001
1pp0010000000000000u0000000000001000pp1
111101000000001111111111100000001011111
100001000000000000010000000000001000001
100000000000000000101000000000000000001
1000000000000000010u0100000000000000001
100000000000000011111110000000000000001
100011111111000000000000000111111110001
100000000000000000000000000000000000001
100000000000000000000000000000000000001
100000000000000000010000000000000000001
111110000000000000010000000000000011111
100000000000000011111110000000000000001
1u00000000000000000000000000000000000u1
111110000000000000000000000000000011111
100000000000000000000000000000000000001
100000000000000000000000000000000000001
100000000001111111111111111100000000001
100000000000000000000000000000000000001
10000000000u000000000000000u00000000001
111111111111111111111111111111111111111