block.fbx
block.fbx
attributes
height=20
width=34
map
1111111111111111111111111111111111
1000000000000000000000000000000001
1000000000000000000000000000000001
1000000000001111111111000000001111
1000000000000000000000000000000001
1111000000000000000000000000000001
10000000000000u000u000000000000001
1000000000000011111000000000001111
1000000000000000000000000000000001
1000000000000000000000000000000001
1111000000000000000000000000000001
1000000000000000100000000000000001
1000000000000000100000000000000001
1000000000000000100000000000111111
10u0000000000000100000000000000001
1111000000000000100000000000000001
1000000000000000000000000000000001
1000000000000000000000000000000001
10pp00000000000000000000000000pp01
1111111111111111111111111111111111
depth1
0000000000000000000000000000000000
0000000000000000000000000000000000
0000000000000011111111111100000000
0000000000000011111111111100000000
0000000000000011111111111100000000
0000011110000011111111111100000000
0000011110000011111111111100000000
0000011110000000000000000000000000
0000011110000000000000000000000000
0000011110000000011111110000000000
0000000000000000011111110000000000
0000000000000000011111110000000000
0011111000000000011111110000000000
1101111000000000011111110000000000
1101111000000000000000000000000000
1111111110000000000000000000000000
1111111111000000000000000000000000
1111111001100000000000000000000000
1111111001100000000000000000000000
1111111111110000000000000000000000
depth2
0000000000000000000000000000000000
0000000000000000000000000000000000
0000000111111110000000000000000000
0000000111111110000000000000000000
0000000111111110000000000000000000
0000000111111111111100000000000000
0000000111111111111100000000000000
0000000111111111111100000000000000
0000000000000011111100000000000000
0000000000000011111100000000000000
0000000000000011111100000000000000
0000000000000011111100000000000000
0000000000000000000000000000000000
0010000000000000000000000000000000
0010000000000000000000000000000000
0000000000000000000000000000000000
0000000000000000000000000000000000
0000000110000000000000000000000000
0000000110000000000000000000000000
0000000000000000000000000000000000
