map
1111111111111111111111111111111111111111111111111111111
1000000000000111111111111111111111111111110000000000001
1000000000000111111111111111111111111111110000000000001
1p0p0p0000000111111111111111111111111111110000000p0p0p1
1111111110000111111111111111111111111111110000111111111
1000000000000111111111111111111111111111110000000000001
1000000000000111111111111111111111111111110000000000001
1000000000000111111111111111111111111111110000000000001
1000000000000111111111111111111111111111110000000000001
10000u0u0u0u0111111111111111111111111111110u0u0u0u00001
1000111111111100000000000000000000000000011111111110001
1000000000000000000000000000000000000000000000000000001
1000000000000000000000000000000000000000000000000000001
1000000000000000000000000000000000000000000000000000001
1000000000000000000000000000000000000000000000000000001
1000000000000000000000000000000000000000000000000000001
1000000000000000000000000000000000000000000000000000001
10000000000000000000000000uuu00000000000000000000000001
1111111111111111111111111111111111111111111111111111111
0000000000000000000000000000000000000000000000000000000
0000000000000000000000000000000000000000000000000000000
0000000000000000000000000000000000000000000000000000000
0000000000000000000000000000000000000000000000000000000
0000000000000000000000000000000000000000000000000000000
0000000000000000000000000000000000000000000000000000000
0000000000000000000000000000000000000000000000000000000
0000000000000000000000000000000000000000000000000000000
0000000000000000000000000000000000000000000000000000000
0000000000000000000000000000000000000000000000000000000
0000000000000000000000000000000000000000000000000000000
0000000000000000000000000000000000000000000000000000000
0000000000000000000000000000000000000000000000000000000
0000000000000000000000000000000000000000000000000000000