block.fbx
block.fbx
attributes
height=20
width=34
map
1111111111111111111111111111111111
1000000000000000000000000000000001
1000000000000000000000000000000001
1000000000001111111111000000001111
1000000000000000000000000000000001
1111000000000000000000000000000001
1000000000000010000000000000000001
1000000000000011111000000000001111
1000000000000000000000000000000001
1000000000000000000000000000000001
1111000001010000000001111000000001
1000000001010000000000000000000001
1000000001010000000000000000000001
1000000011110000000000000011111111
1000000000010000000000000000000001
1111000000010000000000000000000001
1000000000000000000011110000000001
1000000000000000000000000000000001
1000000000000000000000000000000001
1111111111111111111111111111111111
depth1
0000000000000000000000000000000000
0000000000000000000000000000000000
0000000000000000000000000000000000
0000000000000000000000000000000000
0000000000000000000000000000000000
0000000000000000000000000000000000
0000000000000000000000000000000000
0000000000000000000000000000000000
0000000000000000000000000000000000
0000000000000000000000000000000000
0000000000000000000000000000000000
0000000000000000000000000000000000
0011111000000000000000000000000000
1101111000000000000000000000000000
1101111000000000000000000000000000
1111111110000000000000000000000000
1111111111000000000000000000000000
1111111011100000000000000000000000
1111111011100000000000000000000000
1111111111110000000000000000000000
depth2
0000000000000000000000000000000000
0000000000000000000000000000000000
0000000000000000000000000000000000
0000000000000000000000000000000000
0000000000000000000000000000000000
0000000000000000000000000000000000
0000000000000000000000000000000000
0000000000000000000000000000000000
0000000000000000000000000000000000
0000000000000000000000000000000000
0000000000000000000000000000000000
0000000000000000000000000000000000
0000000000000000000000000000000000
0010000000000000000000000000000000
0010000000000000000000000000000000
0000000000000000000000000000000000
0000000000000000000000000000000000
0000000100000000000000000000000000
0000000100000000000000000000000000
0000000000000000000000000000000000
