block.fbx
attributes
height=20
width=34
map
111111111 11111111 11111111 111111111
100000000 00000000 00000000 000000001
100000000 00000c00 00c00000 000000001
10000c100 00011110 01111000 001c00001
100011100 00000000 00000000 001110001
100000100 00000000 00000000 001000001
100000100 0000u000 000u0000 001000001
1000u0000 00001001 10010000 0000u0001
100010000 00001000 00010000 000010001
100000000 00000000 00000000 000000001
100000000 0000000u u0000000 000000001
100000u00 00000001 10000000 00u000001
100001111 11100000 00000111 111100001
100000000 00000000 00000000 000000001
100000000 00000000 00000000 000000001
100u00000 00000c00 00c00000 00000u001
111110000 00001110 01110000 000011111
100000010 00000000 00000000 010000001
1p0p0u010 0000c000 000c0000 010u0p0p1
111111111 11111111 11111111 111111111
