block.fbx
attributes
height=10
width=17
map
11111111111111111
10000000000000001
10000000000000001
11000000100000011
10001000000000001
10000000000010001
10000001000000001
1p0100000000010p1
10010000000001001
11111111111111111
