block.fbx
attributes
height=40
width=68
map
11111111111111111111111111111111111111111111111111111111111111111111
10000000000000000000000000000000000000000000000000000000000000000001
10000000000000000000000000000000000000000000000000000000000000000001
10000000000011111111110000000011111000000000001111111111000000001111
10000000000000000000000000000000000000000000000000000000000000000001
11110000000000000000000000000000011111000000000000000000000000000001
10000000000000000000000000000000000000000000000000000000000000000001
10000000000000111110000000000011111000000000000011111000000000001111
10000000000000000000000000000000000000000000000000000000000000000001
10000000000000000000000000000000000000000000000000000000000000000001
11110000000000000000011110000000011111000000000000000001111000000001
10000000000000000000000000000000000000000000000000000000000000000001
10000000000000000000000000000000000000000000000000000000000000000001
10000000111100000000000000111111111000000011110000000000000011111111
10000000000100000000000000000000000000000000010000000000000000000001
11110000000100000000000000000000011111000000010000000000000000000001
10000000000000000000111100000000000000000000000000000011110000000001
10000000000000000000000000000000000000000000000000000000000000000001
10000000000000000000000000000000000000000000000000000000000000000001
10000000000001111111111111111111111111111111111111111110000000000001
10000000000001111111111111111111111111111111111111111110000000000001
10000000000000000000000000000000000000000000000000000000000000000001
10000000000000000000000000000000000000000000000000000000000000000001
10000000000011111111110000000011111000000000001111111111000000001111
10000000000000000000000000000000000000000000000000000000000000000001
11110000000000000000000000000000011111000000000000000000000000000001
10000000000000000000000000000000000000000000000000000000000000000001
10000000000000111110000000000011111000000000000011111000000000001111
10000000000000000000000000000000000000000000000000000000000000000001
10000000000000000000000000000000000000000000000000000000000000000001
11110000000000000000011110000000011111000000000000000001111000000001
10000000000000000000000000000000000000000000000000000000000000000001
10000000000000000000000000000000000000000000000000000000000000000001
10000000111100000000000000111111111000000011110000000000000011111111
10000000000100000000000000000000000000000000010000000000000000000001
11110000000100000000000000000000011111000000010000000000000000000001
10000000000000000000111100000000000000000000000000000011110000000001
10000000000000000000000000000000000000000000000000000000000000000001
10000000000000000000000000000000000000000000000000000000000000000001
11111111111111111111111111111111111111111111111111111111111111111111