block.fbx
block.fbx
attributes
height=40
width=69
map
111111111111111111111111111111111111111111111111111111111111111111111
100000000000000000000000000000000000000000000000000000000000000000001
100000000000000000000000000000000000000000000000000000000000000000001
1000h00000000000000000000000000000c00000000000000000000000000000h0001
111111110000000000000000000000111111111000000000000000000000011111111
100000000000000000000u0000000000000000000000000u000000000000000000001
100000000000000000111111100000000000000000001111111000000000000000001
100000000000000000000000000000000000000000000000000000000000000000001
100000000000000000000000000000000000000000000000000000000000000000001
100000000000000000000000111111100000001111111000000000000000000000001
100000000000000000000000000000000000000000000000000000000000000000001
100000000000000000000000000000000000000000000000000000000000000000001
10p000000000000000000000000000000000000000000000000000000000000000p01
111110000000000000000000000000000000000000000000000000000000000011111
100000000000000000000000000000000000000000000000000000000000000000001
10u000000000000000000000000000000000000000000000000000000000000000u01
1111110000000000000000000000000000u0000000000000000000000000000111111
100000000000000000000100000001111111111100000001000000000000000000001
100000000000000000000100000000000000000000000001000000000000000000001
100000000000000000000100000000000000000000000001000000000000000000001
1000000000000000000h01000000000000000000000000010h0000000000000000001
1000000000000001111111000000000000c0000000000001111111000000000000001
100000000000000000000100000001111111111100000001000000000000000000001
100000000000000000000000000000000000000000000000000000000000000000001
100000000000000000000000000000000000000000000000000000000000000000001
100000000000000000000000000000000000000000000000000000000000000000001
100000000000000000000000u00000000hhh00000000u000000000000000000000001
100000000000000000000111111111111111111111111111000000000000000000001
100000000000000000000000000000000111000000000000000000000000000000001
100000000000000000000000000000000111000000000000000000000000000000001
100p0000000000000000000000000000011100000000000000000000000000000p001
111111000000000000000000000000000000000000000000000000000000000111111
000000000000000000000000000000000000000000000000000000000000000000001
000000000000000000000000000000000000000000000000000000000000000000001
00000000000000000hhh00000000000000000000000000000hhh00000000000000001
000000000000000111111110000000000000000000000011111111000000000000001
000000000100000000000000000000000000000000000000000000000001000000001
000000000100000000000000000000000000000000000000000000000001000000001
000p00000100000000u000000000000000c000000000000000u00000000100000p001
111111111111111111111111111111111111111111111111111111111111111111111
depth1
000000000000000000000000000000000000000000000000000000000000000000000
000111000000000000000000000000000000000000000000000000000000000111000
000101000000000000000000000000000000000000000000000000000000000101000
000101000000000000000000000000000000000000000000000000000000000101000
000111000000000000000000000000000000000000000000000000000000000111000
000000000000000000000000000000000000000000000000000000000000000000000
000000000000000000000000000000000000000000000000000000000000000000000
000000000000000000000000000000000000000000000000000000000000000000000
000000000000000000000000000000000000000000000000000000000000000000000
000000000000000000000000000000000000000000000000000000000000000000000
000000000000000000000000000000000000000000000000000000000000000000000
000000000000000000000000000000000000000000000000000000000000000000000
000000000000000000000000000000000000000000000000000000000000000000000
000000000000000000000000000000000000000000000000000000000000000000000
000000000000000000000000000000000000000000000000000000000000000000000
000000000000000000000000000000000000000000000000000000000000000000000
000000000000000000000000000000000000000000000000000000000000000000000
000000000000000000000000000000000000000000000000000000000000000000000
000000000000000000111000000000000000000000000000111000000000000000000
000000000000000000101000000000000000000000000000101000000000000000000
0000000000000000001h10000000000000000000000000001h1000000000000000000
000000000000000000111000000000000000000000000000111000000000000000000
000000000000000000000000000000000000000000000000000000000000000000000
000000000000000000000000000000000000000000000000000000000000000000000
000000000000000000000000000000001111100000000000000000000000000000000
000000000000000000000000000000001000100000000000000000000000000000000
000000000000000000000000000000001h0h100000000000000000000000000000000
000000000000000000000000000000001111100000000000000000000000000000000
000000000000000000000000000000000000000000000000000000000000000000000
000000000000000000000000000000000000000000000000000000000000000000000
000000000000000000000000000000000000000000000000000000000000000000000
000000000000000000000000000000000000000000000000000000000000000000000
000000000000000011111000000000000000000000000000111110000000000000000
000000000000000010001000000000000000000000000000100010000000000000000
00000000000000001hhh10000000000000000000000000001hhh10000000000000000
000000000000000011111000000000000000000000000000111110000000000000000
000000000000000000000000000000000000000000000000000000000000000000000
000000000000000000000000000000000000000000000000000000000000000000000
000000000000000000000000000000000000000000000000000000000000000000000
000000000000000000000000000000000000000000000000000000000000000000000
depth2
000000000000000000000000000000000000000000000000000000000000000000000
000111000000000000000000000000000000000000000000000000000000000111000
000111000000000000000000000000000000000000000000000000000000000111000
000111000000000000000000000000000000000000000000000000000000000111000
000111000000000000000000000000000000000000000000000000000000000111000
000000000000000000000000000000000000000000000000000000000000000000000
000000000000000000000000000000000000000000000000000000000000000000000
000000000000000000000000000000000000000000000000000000000000000000000
000000000000000000000000000000000000000000000000000000000000000000000
000000000000000000000000000000000000000000000000000000000000000000000
000000000000000000000000000000000000000000000000000000000000000000000
000000000000000000000000000000000000000000000000000000000000000000000
000000000000000000000000000000000000000000000000000000000000000000000
000000000000000000000000000000000000000000000000000000000000000000000
000000000000000000000000000000000000000000000000000000000000000000000
000000000000000000000000000000000000000000000000000000000000000000000
000000000000000000000000000000000000000000000000000000000000000000000
000000000000000000000000000000000000000000000000000000000000000000000
000000000000000000111000000000000000000000000000111000000000000000000
000000000000000000111000000000000000000000000000111000000000000000000
000000000000000000111000000000000000000000000000111000000000000000000
000000000000000000111000000000000000000000000000111000000000000000000
000000000000000000000000000000000000000000000000000000000000000000000
000000000000000000000000000000000000000000000000000000000000000000000
000000000000000000000000000000001111100000000000000000000000000000000
000000000000000000000000000000001111100000000000000000000000000000000
000000000000000000000000000000001111100000000000000000000000000000000
000000000000000000000000000000001111100000000000000000000000000000000
000000000000000000000000000000000000000000000000000000000000000000000
000000000000000000000000000000000000000000000000000000000000000000000
000000000000000000000000000000000000000000000000000000000000000000000
000000000000000000000000000000000000000000000000000000000000000000000
000000000000000011111000000000000000000000000000111110000000000000000
000000000000000011111000000000000000000000000000111110000000000000000
000000000000000011111000000000000000000000000000111110000000000000000
000000000000000011111000000000000000000000000000111110000000000000000
000000000000000000000000000000000000000000000000000000000000000000000
000000000000000000000000000000000000000000000000000000000000000000000
000000000000000000000000000000000000000000000000000000000000000000000
000000000000000000000000000000000000000000000000000000000000000000000