block.fbx
attributes
height=10
width=17
map
11111111111111111
10000000000000001
1000000000u000001
10111000011100001
10000000000000001
10000000000000001
10000000000000001
1p0000000000000p1
10000ccccc0000001
11111111111111111