block.fbx
attributes
height=5
width=15
map
101010101011111
000000011100111
000000000000000
011010101010110
101010101010100