block.fbx
attributes
height=10
width=17
map
11111111111111111
10000000000000001
1000000000u000001
10000000011100001
10011100000000001
10000000000000001
100000c0000c00001
1p0000110111000p1
10110000000000001
11111111111111111