block1.fbx
map
101010101011111
010000011100111
000000000000000
101010101010110
101010101010100