block.fbx
block.fbx
attributes
height=20
width=34
map
1111111111111111111111111111111111
1000000000000000000000000000000001
10000000000000uuuuuu00000000000001
1000000000001111111111000000001111
1000000000000000000000000000000001
1111000000000000000000000000000001
1000000000000000c00000000000000001
1000000000000011111000000000001111
1000000000000000000000000000000001
1000000000000000000000000000000001
1111000000000000c00000000000000001
1000000000000000100000000000000001
1000000000000000100000000000000001
1000000000000000100000000000111111
10h0000000000000100000000000000001
1111000000000000100000000000000001
1000000000000000000000000000000001
1000000000000000000000000000000001
10pp0000uuuuuuuuuuuuuuu0000000pp01
1111111111111111111111111111111111
