map
000000000000000000000000000000000000000
000000000000000000000000000000000000000
000000000000000000000000000000000000000
000111111111111111111111111111111111000
000100000000000000000000000000000001000
00010000000000000uuuuu00000000000001000
000100000000000111111111000000001111000
000100000000000000000000000000000001000
000111100000000000000000000000000001000
0001000000000000000c0000000000000001000
000100000000000001111100000000001111000
000100000000000000010000000000000001000
000100000000000000000000000000000001000
000111100000000000000000000000000001000
0001000000000000000c0000000000000001000
000100000000000001111100000000000001000
000100000000000000000000000000111111000
00010h000000000000000000000000000000000
000111100000000000000000000000000000000
000000000000000000000000000000000000000
000000000000000000000000000000000000000
00000pp0000uuuuuuuuuuuuuuu000000pp00000
000111111111111111111111111111111111000
000000000000000000000000000000000000000
000000000000000000000000000000000000000
000000000000000000000000000000000000000
