map
11111111111111111111111111111111111111111111111111111111111111111
10000000000000000000000000000000000000000000000000000000000000001
10000000000000000000000000000000000000000000000000000000000000001
10000000000000000000000000000000000000000000000000000000000000001
10000000000000000000000010000000000000001000000000000000000000001
100p000000000000000000001000000000000000100000000000000000000p001
11111110000000000000000010000000000000001000000000000000001111111
10000000000000000000000010000000c00000001000000000000000000000001
10000000000000000000000011111111111111111000000000000000000000001
10000000000000000000000000000000000000000000000000000000000000001
10000000000000000000000000u00000000000u00000000000000000000000001
10000000000000000000000011111111111111111000000000000000000000001
10000000000000000000000000000000000000000000000000000000000000001
10000u00000000000000000000000000000000000000000000000000000u00001
11111111111110000000000000000000000000000000000000001111111111111
00000000000010000000000000000000000000000000000000001000000000000
00000000000010000000000000000000c00000000000000000001000000000000
00000000000010000000000000011111111111000000000000001000000000000
00000000000010000000000000000001110000000000000000001000000000000
00000000000010000000000000000000100000000000000000001000000000000
0000u000u00010000000000000000000000000000000000000001000u000u0000
111111111111100000000000u000000000000000u000000000001111111111111
10000000000000000000001111100000000000111110000000000000000000001
10000000000000000000000000000000000000000000000000000000000000001
10000000000000000000000000000000000000000000000000000000000000001
10000000000000000000000000000000000000000000000000000000000000001
10000000000000000000000000000000000000000000000000000000000000001
10000000000000000000000000000000000000000000000000000000000000001
100p000000000000000000000000000000000000000000000000000000000p001
11111110000000000000000000000000000000000000000000000000001111111
10000000000000000000000000001110001110000000000000000000000000001
10000000000000000000000000001000000010000000000000000000000000001
10000000000000000000000000001000000010000000000000000000000000001
10000000000000000000000000001000000010000000000000000000000000001
100u00000000000000000000u0001000c0001000u00000000000000000000u001
11111111111111111111111111111111111111111111111111111111111111111