map
111111111111111111111111111111111111111111111111111111111111111111111
100000000000000000000000000000000000000000000000000000000000000000001
100000000000000000000000000000000000000000000000000000000000000000001
1000000000000000000000000000000000c0000000000000000000000000000000001
111111110000000000000000000000111111111000000000000000000000011111111
100000000000000000000u0000000000000000000000000u000000000000000000001
100000000000000000111111100000000000000000001111111000000000000000001
100000000000000000000000000000000000000000000000000000000000000000001
100000000000000000000000000000000000000000000000000000000000000000001
100000000000000000000000111111100000001111111000000000000000000000001
100000000000000000000000000000000000000000000000000000000000000000001
100000000000000000000000000000000000000000000000000000000000000000001
10p000000000000000000000000000000000000000000000000000000000000000p01
111110000000000000000000000000000000000000000000000000000000000011111
100000000000000000000000000000000000000000000000000000000000000000001
10u000000000000000000000000000000000000000000000000000000000000000u01
1111110000000000000000000000000000u0000000000000000000000000000111111
100000000000000000000100000001111111111100000001000000000000000000001
100000000000000000000100000000000000000000000001000000000000000000001
100000000000000000000100000000000000000000000001000000000000000000001
100000000000000000000100000000000000000000000001000000000000000000001
1000000000000001111111000000000000c0000000000001111111000000000000001
100000000000000000000100000001111111111100000001000000000000000000001
100000000000000000000000000000000000000000000000000000000000000000001
100000000000000000000000000000000000000000000000000000000000000000001
100000000000000000000000000000000000000000000000000000000000000000001
100000000000000000000000u0000000000000000000u000000000000000000000001
100000000000000000000111111111111111111111111111000000000000000000001
100000000000000000000000000000000111000000000000000000000000000000001
100000000000000000000000000000000111000000000000000000000000000000001
100p0000000000000000000000000000011100000000000000000000000000000p001
111111000000000000000000000000000000000000000000000000000000000111111
100000000000000000000000000000000000000000000000000000000000000000001
100000000000000000000000000000000000000000000000000000000000000000001
100000000000000000000000000000000000000000000000000000000000000000001
100000000000000111111110000000000000000000000011111111000000000000001
100000000100000000000000000000000000000000000000000000000001000000001
100000000100000000000000000000000000000000000000000000000001000000001
100p00000100000000u000000000000000c000000000000000u00000000100000p001
111111111111111111111111111111111111111111111111111111111111111111111