block.fbx
attributes
height=20
width=34
map
1111111111111111111111111111111111
1000000000000000000000000000000001
10000000000000c0000c00000000000001
10000c1000001111001111000001c00001
1000111000000000000000000001110001
1000001000000000000000000001000001
1000001000000u000000u0000001000001
1000u000000001001100100000000u0001
1000100000000100000010000000010001
1000000000000000000000000000000001
1000000000000000uu0000000000000001
100000u00000000011000000000u000001
1000011111110000000000111111100001
1000000000000000000000000000000001
1000000000000000000000000000000001
100u0000000000c0000c0000000000u001
1111100000000111001110000000011111
1000000100000000000000000010000001
1p0p0u0100000c000000c0000010u0p0p1
1111111111111111111111111111111111
