block.fbx
block.fbx
attributes
height=40
width=68
map
11111111111111111111111111111111111111111111111111111111111111111111
10000000000000000000000000000000000000000000000000000000000000000001
10000000000000000000000000000000c00000000000000000h00000000000000h01
10000000000011111111110000000011111000000000001111111111000000001111
10p00000000000000000000000000000000u00000000000000000000000000000001
11110000000000000000000000000000011111000000000000000000000000000001
100000000000000h0000000000000000000000000000000000000000000000000p01
10000000000000111110000000000011111000000000000011111000000000001111
10000000000000000000000000000000000000000000000000000000000000000001
10p00000000000000000000000000000000u00000000000000000000000000000001
11110000000000000000011110000000011111000000000000000001111000000001
10000000000000000000000000000000000000000000000000000000000000000001
100000000h0000000000000000000000000000000000000000000000000000h00p01
10000000111100000000000000111111111000000011110000000000000011111111
10p00000000010000000000000000000000000000000001000000000000000000001
11110000000100000000000000000000011111000000010000000000000000000001
10000000000000000000111100000000000000000000000000000011110000000001
10000000000000000000000000000000000000000000000000000000000000000001
100000000000000h0000c0000000000h000u000000c0000000h00000000000000001
10000000000001111111111111111111111111111111111111111110000000000001
10000000000001111111111111111111111111111111111111111110000000000001
10000000000000000000000000000000000000000000000000000000000000000001
10000000000000000000000000000000000000000000000000000000000000000p01
10000000000011111111110000000011111000000000001111111111000000001111
10p00000000000000000000000000000000000000000000000000000000000000001
11110000000000000000000000000000011111000000000000000000000000000001
100000000000000h0000000000000000000000000000000000000000000000000p01
10000000000000111110000000000011111000000000000011111000000000001111
10000000000000000000000000000000000000000000000000000000000000000001
10p0000000000000000000000000000000u000000000000000000000000000000001
11110000000000000000011110000000011111000000000000000001111000000001
10000000000000000000000000000000000000000000000000000000000000000001
10000000000000000000000000000c00000000000000000000000000000000000p01
10000000111100000000000000111111111000000011110000000000000011111111
10p00000000100000000000000000000000000000000010000000000000000000001
11110000000100000000000000000000011111000000010000000000000000000001
10000000000000000000111100000000000000000000000000000011110000000001
10000000000000000000000000000000000000000000000000000000000000000001
1000000000h0000000000000000000000u000h00000000000000000000000h000p01
11111111111111111111111111111111111111111111111111111111111111111111
depth1
00000000000000000000000000000000000000000000000000000000000000000000
00000000000000000000000000000000000000000000000001010000000000001010
00000000000000000000000000000000000000000000000001010000000000001010
00000000000000000000000000000000000000000000000001110000000000001110
00000000000000111000000000000000000000000000000000000000000000000000
00000000000000101000000000000000000000000000000000000000000000000000
00000000000000101000000000000000000000000000000000000000000000000000
00000000000000111000000000000000000000000000000000000000000000000000
00000000000000000000000000000000000000000000000000000000000000000000
00000000000000000000000000000000000000000000000000000000000000000000
00000000111000000000000000000000000000000000000000000000000001110000
00000000101000000000000000000000000000000000000000000000000001010000
00000000101000000000000000000000000000000000000000000000000001010000
00000000111000000000000000000000000000000000000000000000000001110000
00000000000000000000000000000000000000000000000000000000000000000000
00000000000000000000000000000000000000000000000000000000000000000000
00000000000000111000000000000011100000000000000001110000000000000000
00000000000000101000000000000010100000000000000001010000000000000000
00000000000000101000000000000010100000000000000001010000000000000000
00000000000000111000000000000011100000000000000001110000000000000000
00000000000000000000000000000000000000000000000000000000000000000000
00000000000000000000000000000000000000000000000000000000000000000000
00000000000000000000000000000000000000000000000000000000000000000000
00000000000000000000000000000000000000000000000000000000000000000000
00000000000000111000000000000000000000000000000000000000000000000000
00000000000000101000000000000000000000000000000000000000000000000000
00000000000000101000000000000000000000000000000000000000000000000000
00000000000000111000000000000000000000000000000000000000000000000000
00000000000000000000000000000000000000000000000000000000000000000000
00000000000000000000000000000000000000000000000000000000000000000000
00000000000000000000000000000000000000000000000000000000000000000000
00000000000000000000000000000000000000000000000000000000000000000000
00000000000000000000000000000000000000000000000000000000000000000000
00000000000000000000000000000000000000000000000000000000000000000000
00000000000000000000000000000000000000000000000000000000000000000000
00000000000000000000000000000000000000000000000000000000000000000000
00000000011100000000000000000000000011100000000000000000000011100000
00000000010100000000000000000000000010100000000000000000000010100000
00000000010100000000000000000000000010100000000000000000000010100000
00000000011100000000000000000000000011100000000000000000000011100000
depth2
00000000000000000000000000000000000000000000000000000000000000000000
00000000000000000000000000000000000000000000000001110000000000001110
00000000000000000000000000000000000000000000000001110000000000001110
00000000000000000000000000000000000000000000000001110000000000001110
00000000000000111000000000000000000000000000000000000000000000000000
00000000000000111000000000000000000000000000000000000000000000000000
00000000000000111000000000000000000000000000000000000000000000000000
00000000000000111000000000000000000000000000000000000000000000000000
00000000000000000000000000000000000000000000000000000000000000000000
00000000000000000000000000000000000000000000000000000000000000000000
00000000111000000000000000000000000000000000000000000000000001110000
00000000111000000000000000000000000000000000000000000000000001110000
00000000111000000000000000000000000000000000000000000000000001110000
00000000111000000000000000000000000000000000000000000000000001110000
00000000000000000000000000000000000000000000000000000000000000000000
00000000000000000000000000000000000000000000000000000000000000000000
00000000000000111000000000000011100000000000000001110000000000000000
00000000000000111000000000000011100000000000000001110000000000000000
00000000000000111000000000000011100000000000000001110000000000000000
00000000000000111000000000000011100000000000000001110000000000000000
00000000000000000000000000000000000000000000000000000000000000000000
00000000000000000000000000000000000000000000000000000000000000000000
00000000000000000000000000000000000000000000000000000000000000000000
00000000000000000000000000000000000000000000000000000000000000000000
00000000000000111000000000000000000000000000000000000000000000000000
00000000000000111000000000000000000000000000000000000000000000000000
00000000000000111000000000000000000000000000000000000000000000000000
00000000000000111000000000000000000000000000000000000000000000000000
00000000000000000000000000000000000000000000000000000000000000000000
00000000000000000000000000000000000000000000000000000000000000000000
00000000000000000000000000000000000000000000000000000000000000000000
00000000000000000000000000000000000000000000000000000000000000000000
00000000000000000000000000000000000000000000000000000000000000000000
00000000000000000000000000000000000000000000000000000000000000000000
00000000000000000000000000000000000000000000000000000000000000000000
00000000000000000000000000000000000000000000000000000000000000000000
00000000011100000000000000000000000011100000000000000000000011100000
00000000011100000000000000000000000011100000000000000000000011100000
00000000011100000000000000000000000011100000000000000000000011100000
00000000000000000000000000000000000000000000000000000000000000000000