block.fbx
attributes
height=20
width=34
map
1111111111111111111111111111111111
1000000000000000000000000000000001
1000000000000000000000000000000001
1000000000001111111111000000001111
1000000000000000000000000000000001
1111000000000000000000000000000001
100000000000000uu00000000000000001
1000000000000011111000000000001111
1000000000000000000000000000000001
10000000000000000000000u0000000001
1111000000000000000001111000000001
1000000000000000000000000000000001
1000000000000000000000000000000001
1000000011110000000000000011111111
100c000000010000000000000000000001
11110000000100000000c0000000000001
1000000000000000000011110000000001
1000000000000000000000000000000001
1p0000000000c0000000000000000000p1
1111111111111111111111111111111111