map
111111111111111111111111111111111111111111111111111111111111111111111
100000100000000000000010000000000000000000000010000000000000001000001
100000000000000000000000000000000000000000000000000000000000000000001
100000000000000000000000000000000000000000000000000000000000000000001
100000000000000000000000000000000000000000000000000000000000000000001
100000100000000000000010000000000000000000000010000000000000001000001
100p0010000000000u0000100000000000c0000000000010000u0000000000100p001
111111111100011111111110000011111111111110000011111111110001111111111
100000100000000000000000000000000000000000000000000000000000001000001
100000100000000000000000000000000000000000000000000000000000001000001
100000000000000000000000000000000000000000000000000000000000000000001
100000000000000000000000000000000000000000000000000000000000000000001
100000000000000000000000000000011101110000000000000000000000000000001
100000100000000000000000000000010000010000000000000000000000001000001
100u0010000000000000000000000001000001000000000000000000000000100u001
1111111000000000000000000000000100c0010000000000000000000000001111111
100000100000000000000000000000010111010000000000000000000000001000001
100000100000000000000000000000000000000000000000000000000000001000001
100000000000000000000000000000000000000000000000000000000000000000001
100000000000000000000000000000000000000000000000000000000000000000001
100000000000000000000000000000000000000000000000000000000000000000001
100000100000000001101100000000000000000000000011011000000000001000001
100p001000000000010001000000000000c000000000001000100000000000100p001
111111100000000001000100000111111111111110000010001000000000001111111
1000001000000000010u0100000000000000000000000010u01000000000001000001
100000100000000001111100000000000000000000000011111000000000001000001
100000000000000000000000000000000000000000000000000000000000000000001
100000000000000000000000000000000000000000000000000000000000000000001
100000000000000000000000000000000000000000000000000000000000000000001
1000001000000000000000000u0000000000000000u00000000000000000001000001
100u0010000000000000000111100000000000000111100000000000000000100u001
111111100000000000000111001000000000000001001110000000000000001111111
100000100000000000u111000010000000000000010000111u0000000000001000001
100000100000000001110000001000000000000001000000111000000000001000001
100000000000000111000000001000000000000001000000001110000000000000001
100000000000011100000000001111000000001111000000000011100000000000001
100000000001110000000000000000000000000000000000000000111000000000001
100000100000000000000000000000000000000000000000000000000000001000001
100p001000000000000000000000000000c000000000000000000000000000100p001
111111111111111111111111111111111111111111111111111111111111111111111